%%%%%%%
%  .  %
%. P .%
%  .  %
%%%%%%%
