%%%%%%%%%%%%%%%%%%%%%%%%%%%%%%%%%%%%%%%%%%%%%%%%%
%      P      .%             %  .% .   %.%  .%. %
% %%%%%%% %%%%%% %  % % %%         %%%%  %  %%% %
%    %.%    % .% %  % %  %   %   %       %  %   %
%   .%    .      %.   % %%%% %   %% .%%%%%  %   %
%%%%%%% %%%%%%  %%%%%%%          .%    %. %     %
%.          .%       .% %%%  %%%%%%  % %  % % % %
%%%%%%%%%%%%%%%%%%%%%%% %    %  . %% % %    %.% %
%    %  %      %  %     % %%%%       %.  %%%%.% %
%.      %%  %. %  %     %          %       .%   %
% % %%%    % %    %%%%% %%%%%% %  % %%%%%%%%%%% %
%   %    %    %             .%    %      % .    %
%%%%%%%%%%%%%%%%%%%%%%%%%%%%%%%%%%%%%%%%%%%%%%%%%
