%%%%%%%%%%%%%
%    .     .%
%        . .%
%  . P . . .%
% .         %
% .         %
% .         %
%%%%%%%%%%%%%
