%%%%%%%%%%%%%%%%%%%%%%%%%%%%%%
%      P      .%      .  .   %
% %%%%%%% %%%%%% %  % % %%   %
%   %.       % . %  % %  %. .%
%.           .   %.   %  %%% %
%%%%%%%%%%%%%%  %%%%%%%     .%
%..              .   .% %%%  %
%%%%%%%%%%%%%%%%%%%%%%% %   .%
%      .%         %     % %%%%
%       %% %%     %.    %   .%
%.% %%%    % %%   %%%%% %%%%%%
%            .%             .%
%%%%%%%%%%%%%%%%%%%%%%%%%%%%%%
